building rooms!
building rooms!
                                                                                
                                                                                
                  #####                               #####                     
                  #...#                               #...#      #######        
        ######    #...#                               #...#      #.....#        
        #....#    #...#                               #...#      #.....#        
      \ #....#    #...#                               #...#      #.....#        
        #....#    #...#                               #...#      #.....#        
        #....#    #...#                               #...#      #.....#        
        #....#    #...#                               #####      #.....#        
        #....#    #...#                                          #.....#        
        ######    #...#                                          #.....#        
                  #...#                                          #.....#        
                  #...#                                          #.....#        
                  #...#       #########                          #.....#        
                  #####       #.......#                          #.....#        
                              #.......#                          #.....#        
                              #.......#                          #.....#        
                              #.......#                          #.....#        
     ########                 #########                          #######        
     #......#                                                                   
     #......#                                                                   
     #......#                                                                   
     #......#                ########                                           
     ########                #......#                                           
                             #......#                                           
               ############  #......#                                           
               #..........#  #......#                                           
               #..........#  #......#                                           
               #..........#  #......#                                           
         ##### #..........#  #......#                               ~  #########
         #...# #..........#  #......#                                  #.......#
         #...# ############  #......#                                  #.......#
         #...#               #......#                                  #.......#
         #...#               #......#                                  #########
         #####               #......#              ######                       
                             #......#              #....#                       
                             #......#              #....#                       
                             #......#              #....#                       
                             ########              ######                       

